 EA ./textures/west.png

WE    ./textures/west.png

          SA                 ./textures/west.png     

F   2 , 55,     0   

SO ./textures/west.png
C 0,0,0
NO ./textures/west.png

 11 11111
10111001
101E0101
10111101   
11111111