 EA ./textures/east4.png

WE    ./textures/west4.png


F   0 , 255,     0

SO ./textures/south4.png
C 0,0,255
NO ./textures/north4.png

11111111111
1000010000111
1000010000111
1000010000111
1000010000111
10000000001
1000010000111
1000000S000001
1000010000111
10011100001
1111  11111
