 11 11111
10111001
101E101
10111001   
11111111