 EA ./textures/east.png

WE    ./textures/west.png


F   0 , 255,     0

SO ./textures/south.png
C 0,0,255
NO ./textures/north.png

11111111111
11000010000111
1000010000111
100001000011111111111111111111
100001000000000000000000000000111
100000000011111111111111111111
1000010000111
1000000000001
1000010000111
1000000S000001
100111000011111
1111  11111
