 EA ./textures/east.png

WE    ./textures/west.png


F   0 , 255,     0

SO ./textures/south.png
C 0,0,255
NO ./textures/north.png

11111111
11000001
10000011
10100011
10001001
10001001
10001001
10000111
100N0001
10100101
11111111
