 EA ./textures/west.png

WE    ./textures/west.png

          SA                 ./textures/west.png

F   2 , 55,     0

SO ./textures/west.png
C 0,0,0
NO ./textures/west.png

11111111111
10000000001
10000000001
10000000001
10000000001
10000000001
11111111111
