          EA   ./textures/east.png
WE   ./textures/west.png       
	   SO    ./textures/south.png
NO    ./textures/north.png
    NOS ./test
E ./lsdsdasdfasf
EAE ./amardasdfasf
  F    40,   40, 		40
   C 	 0	, 100,  200
lorem ipsum
11111111111
1N000000001
10000000001 
10000000001 
10000000001
10000000001
10000000001  
10000000001
10000000001
11111111111  

 